####################################################################################################
####################################################################################################
####################################################################################################
##################################################################+#################################
################################################################-. .+###############################
#############################################################-..     +##############################
############################################################+.       ###############################
##########################################################+.        .###############################
######################################################+  .        .+################################
###########################################+.++######.           .+#################################
###########################################+.   ...-+-            ..+###############################
###########################################-.                    .+#################################
###########################################+.                    -##################################
##################################- .++                          .+#################################
###############################++-                               .##################################
##########################+. --                                  -##################################
##########################.                                    ..-##################################
##########################-.                                  .-++##################################
############################.                                     -+################################
###########################-                                      +#################################
##########################+.                                 .... +#################################
#######################-..                                  -#######################################
#########################.                                  .#######################################
#########################.                                  +#######################################
#########################+                                  +#######################################
#########################-                                  .-######################################
#########################.                               .   +######################################
#####################.                                  .+##########################################
########################.                                -##########################################
#########################.                              -###########################################
#########################-                              .+##########################################
##########################-                              .+#########################################
##########################-                              .-++..--###################################
###########################-.                            .--.  .+###################################
############################-                             .-#+#-+###################################
############################+.                            .++..-+###+..-+###########################
#############################.                                  ...     .###########################
############################+.                                           .--########################
#############################-.                                             ########################
#############################+.                                             ..-#####################
##############################.                                              .-#####################
##############################+                                              +######################
###############################...                                   +-.. .+########################
##################################+-                                -###############################
#####################################.                            +#################################
######################################.                           +#################################
#######################################+                         -##################################
#########################################-..                       .################################
###########################################-...                    -################################
###############################################+-.       .....  -###################################
##################################################+-..  .##+########################################
#####################################################-+++###########################################
####################################################################################################
####################################################################################################
####################################################################################################